vtj: jvn jzt jcf
ccj: bgz qxc jqt gkj
crd: cpd mfx cjg nfh
zkn: kfz tmz rlv lhc
szn: hbs qdm tck
fff: mfj grc
dbb: ndd
snv: jll rqt bbm fld
hjz: znd hgs xdj
bcm: ssj pdd mfs rbj grl
zsz: gpn cvs hkj gsj
bch: dqr
ldf: fpc
vjk: qfk jzv rgk
bfl: vbq jlj bjb nkq
nqc: xgp blj krx tcb
fxt: tvq knq
xmr: psv llq bdt
zqk: rgt vfh clx gxm
vls: fff mgj gnx
lfr: xhb msh
mtm: vhn xbk xbb jlq
bqb: vdd jhd kcp khf
qkt: skv fld fgz snl dzm
dfr: ddr
jkl: ttm
tkc: rkx hpk
grb: ccr
fzk: rkk zmn ldt
jnv: sfg lkz
vmq: vcz fcc vqj psv
qxr: xkc nmt
lxr: ftl qln
bdt: xhl
fml: sgv rsn
qjk: zql fbx fmf
hrx: kzt zrq xkh
mkd: xbb
jgj: hjk
tfp: zxx hmt ntr fhq
rjv: kxc hgt fbs hfl gmc
lkp: nlx vmp jfb
jfz: vmt hxp rvc sjg
nff: fcx kpl xhm bxx
pnv: kfb
jfj: dhg gvf rhr nmj
tzm: gvm jtl qxh xrt
kfj: bzs pmb
cqj: lbr
xfh: lhn nbp qvc
qbf: tpm
cdj: psv kjj
thx: kfx
vdp: hsg bsx
hps: dns rbs
dtj: dzp zxl vmb lfr fxv
cqh: rfh vhd
pzd: vgx
pzg: ccr
gnm: rxx
ddv: xfm hlf pbd
rfj: xmx mbl vpl
nsl: tfm fqp xgp nfk
ctv: hnz tlp jbt szd jpd
vtv: hfc zsb nrz kzd
tnb: cfn
lhq: hjk ndr
rhr: ngc vhh
scj: sbd svs dkt kmh
ztz: rfh pgq tgv
xqk: hps nbv rdn fdl
ksb: knb sbq tgm kxb
qln: gnm
fcf: tzt cxz
lkl: xkv lpl
vtt: cjg qgx jhk tdx
gds: gvl dqp sbd
sqh: gsm mtc vtq
qjh: cbh ljm
svs: cdv rlb dmz zrz
fvj: ckj qsf
zzg: jcl qxc hgd
mdr: qdn gkb mrl xpp
fxn: jxx zxv
pkx: zll xfr bvj ncv bjs gkt
rqx: xcz dmj
bkh: znt ftl
mpj: tpr vms htr llq rvb
crh: mft jkb rlb
znd: xkt ktk xbt
tsb: qls vms
dnn: lnb
cbg: cfm llt pqr bpt
bxz: bmm xpp pzf fxn xsq
cgp: bzs lss jdv dhj
llt: nhx qdb
hlf: dlc
rcq: drm lqn qnh
xvr: ccv
zmd: dqp mvr rlb
pcr: hkk jtm nbh
dps: mkd msh llt
njh: vkx
dxk: qbx cqj jsx lkz khd jgl
prx: ntd mdx ccj ggn
hzr: mfh
fcd: lsl
vdn: pxf fml kch dzv
ttf: ldt zrc scs ccq
bgl: xvb ggx
skp: knb rvk mlv tpm vfd mfl
mkr: lnh clv
jks: krr
kqb: nst bsc
pjh: qnh
sbk: zkr pkz
qzm: lkj
mfj: cvs kqh tsl
kpl: qfk gbn nmj kqp lxn mhm
xfs: tzm zzx sxp bpt qdh
dmr: xmx hfp llq
mmd: rxn pqr htc
shb: lkj xfx cfr gvf
hfl: bxc lbl lrj
llg: vzz
qrr: rbf vhd
nnj: lkl qtl
dsm: llg nrh tnb mfq
gnt: sjg sjb vcg gjz
fvt: nsz gmq scs
shm: tzx zjg
bkr: sgv qht
xtk: vxv nkz hlt rfp
qnk: qkn gnm xds
dsp: gmq qxr
xpp: pcs
pzs: hjk
zmc: gvv gvs mgx
czp: grs
zps: dtc bfs dbl mkb mlt zjz
qpk: xkv tjs czp gkb
xxj: bvs
rbf: lvf
dtx: frz jhv fgv tpt
sbs: gvs jbt sgs xbb
kfp: xmb cqk xpv
rgk: jbt
vzq: mbl vst mhs vpl vbh
dvk: ksq
fvr: hpf
ddj: djp
bmv: gff ggx
gxq: pll rrv
pgq: qrr cgp pmb
dnh: cfn xkq nzl
dbd: fgv xgz lnh
rxh: lhh mjk hzr vgx
bgm: pvc
xtm: pfq vjh gzs
ttc: jxg qrv ptr qhk
tsc: bqf lvd qdh tth
kcp: kcb lbk dmb
hkp: rfg szd rhd
gfh: dqp
gps: xhn
kpt: sgq
kxb: qbc xvr bxj
lpx: mck ckp mtc npt
fhg: jss rkg
clb: pbj
gjq: hmp zxg sqg nds
smc: tdf
ggx: chp
tbv: hdk mxr zcx jgx
hnt: llg hlj drc jsc
vkb: slr ftl tzr ddr
lcj: rhd jxh sxz
ztf: fbs
gjz: lzr vmc rpt
sdj: jjr
htm: kbx xsq
vpn: dvd kkx
jzh: ztx
rbv: rlv
fgv: mgj jxh
fzt: qkq qhk jxb dvb fsh qdr
ndm: gps tsl bxx
sff: kkh tgs gff
tkx: dsv ntz kfz khl zpc hdd
xpb: hsz qtv hbv tfm
gmm: skv mjt dns
sdt: fgq jkl hjk lbl
mkg: xmx vpk
npt: knt
clt: bmm
zjg: knq
ccg: lrj clb bkr hnx bkc
ljx: ngc kns lvf
vss: jdv cqs
vbf: hdj djp jkt nfh
tsr: gjm
gcj: qbx kvm msh
jjl: lds bjf
tnd: lnt tsl ztn
jdv: tgg
fgf: dzq hkk khd
bpp: xjj lgg sjb
lgq: xkv msh grl gml sqh
gjc: bqk
xjv: fsq qht hbk
fct: jmh dbl rkk xgb
nqz: sns tkc kdk
grt: qpc nmg jvn
rpt: hsd mqg
qzd: bvj sbd kcp dlt
pnb: tgm sbk rgk vbc
czh: jzv kns bdf xpp
csc: ttg
cqs: bbb dtr
xvx: zxl rfh pzd vrs
rvk: qrz clx
vbq: grb sgv
nll: kmh qnh bmj rvj vqj pzg
gsm: tgg
fjl: qsf lkg nfh
vtg: dnn slv tfm
rfm: mft
hrl: kmq rph gvf kkz
lvr: cmv jhd mrx
xpx: ghb hsz vxx svn
hmn: pcz hjp xgz
vqj: qht
njx: ttm vjr hlf gjm
ngb: cqj kxb xqm ftn
jck: rtx nlf zvp
vsd: dfr prf pvc rkn
rrh: vjr skv vpf ndt
mtj: rlb
ggq: tqk clt ghq
sxp: skl rhx snn
pss: knh ffq
rjk: xkt tmz vzs
ksj: bxx pnl nss prh
qgn: hdt zvs
cfk: fgz zpk xkc
fgc: fmd spq
vxv: rxg hdr
tpx: qbc cxx grs
djg: bkc cgb
vfs: qfb zkr tkl xgh csk
pkj: rfh hmv
vjj: blh srf dzd
bdb: dfr tzr
sdl: cbm lpx dzp bvs
lzq: zfr hpx sjg qsf
lcd: sbp qqm tkp gcv
dzd: kqc blh gsj
hlx: qzb psh chm
lgg: nmg
dzc: tlx nss njj
zks: krl vnt gtk hnm pzs khl
dpj: bjs ndt nqj gmx pxx
gtk: gjh gcv szx
zrz: tdx psh
kbx: qdb jtm
hnp: qph sfg mnh knr hpk
qtf: cxh ljl nmj sxk
dbl: ckj
hsb: dnh tpb tnd jnz
dmb: bmv
frh: xgh kmq
zsq: gfp tck jsc jjr kcv
dmz: ldr cqk
nlv: sbd
ftn: rqj mck rsp
xgp: gbx
lpb: dxk nkd pgx ssj
nlf: sjb tqd
kjk: klz tmx fld dkl
knc: xfr vmz sbd rbv
llv: zlx
zch: xkt jvn jcv
pxf: tdx
lvf: mhk bdk
dtc: xmb cjg
lxf: csk
mbl: vxl
btf: pvn crd hlt hnx
kck: rpb
cmp: xvd hdj fbx nkt
bnv: fbx gst vnk xrk
lgr: fns lbr fxj mzf
jfv: kcc qtl
bjs: cgb rdj
crc: hld
xhz: sgf ztx
dmx: rhd dbt fdp
kxn: grj hkp mgp
frz: vdb psk slr sxf
khb: fgq ktk jdq mtb gvl
vfh: qfk
nxr: sns nbh tmg znt phf
lhh: xnd rpb
xkq: ptr zkr
spn: nlx hqq bdb
dzp: rbj
lpm: qls xgp scs
gzb: bqk qdr fxr npt
zpt: fpf ppj
ljl: vrc zxl
rqt: pjh pxl jdl
gkk: jmh
pfq: fcd kjj kcb
hsm: tkl xhz vnm zlx tzt
tpp: lbl chp
ddl: jgp cvx zqp vhz
hkx: bbs jcl fkg kct
vgx: ntr
hjd: rsp kqh cxh qzp
zzq: xjj vdd tsb
zcx: kcv
zzm: flg bmm ccv
ddr: dnp
hxs: vtq jbp rbj
qvl: qkc vhh xbq thf
cnt: rvb spq zvs
ndd: hdt lrj
bjt: kfx fbx xvd kct
sbx: qdp njn scd lxf clp
txv: pnj vst qjh rqk
khf: vdn sqv
lpd: qgn jdj tmp bbm
qfj: zfj mxg fmd rbt pjh
grc: bsc xks clx
dhv: ztf jzt
rsd: frr mhm ktz tks vrp
nps: gkk drt dhv
sfd: ljm cvs njh ppr mlq
xpv: rbs
mlv: gpn qsh
qbq: zkm vfh gvj gnx
ctg: nkq bch
zpc: blx qgn jgp
lrm: ggq fxr kqb
pqv: fbs ktk fzf sss
vdb: slr ctr gvf
dfp: fvr ccr svn
bgh: dpr vrc rmv
mhs: zpk xmb
pzn: tdx jlj vdd
fpz: mvr nkt gds
rkv: zlr ldr rcx txp pxx
hvf: mkb cdv pxx krl
kqg: fqx hdk qrz
rlc: kqn rtj slv rfr
grg: cjg vmz krf bxc
blh: fxj
gtn: bkc csc ptn
shz: kmj hfc jzj
clp: tgg fxr
bnk: njn qvc
nxv: chm kfp
qfd: scg ccj blx ddz
kvt: bpp vcs vsl grx pvn
jgp: rvc
ltx: qnk ttc kdk llg
jzt: ksq
jsx: bjr pgn qcb
blk: nkq hgs fgp jgj
nst: ntr tqk
rth: rbj vmp cqh
qfx: fmd tsh zqp
jnz: qkn jfx xfq
mtt: krr grx kdf kpc
fxj: vgx rrn
lnn: ncc stb hbs rdl
gqz: zpt gnk
lhn: hpk dpz dkz
zsj: drm
vcg: djp
rph: pfz gst bcb
zsb: tlx rlh
rqp: zlj jvg nld gsj
fvq: jdj kpt zsj zjz xpd qzb txp vms gff
nhx: gcl fcx
rjd: lkz lbr fcf
vpf: njg kfz
jnl: qcb knr msl
vxx: ztd fvt jdq
pxl: xvd vjr
ktg: sss vmz kxc
ccq: vms dns
rrc: rlg zpk
msg: vsl nkf rrv dbl dbb pss
zzx: ktz jgl pcz
gsr: mjk mkd qbb dvb
sxk: bjf rxx
gdh: qkj dmx slr dtr sqc
vfp: fxj bzs lxf zqb
snj: vdt tkp nbn fxm
fjp: zsj dcv mlp pzs gjh kjv
xvb: fqk
gtl: qpx prd rxk bpb
nhs: mrl sdj xgz mck
kqn: crv rxg dtc rrc ffv
xzm: bqs rhd
gmx: jkb ghg lrj vnk bgl
lbl: njx qng
hxp: djp
tcb: rzq fmz fzf rvj
lxn: szn xbq
rtd: qzm tvq slf gvv
kkz: fxl qdp qrr grv
txk: ddr pnv fdq mck rhx mfh bkh
jdj: gjh
pxq: xxl rfr xkc hzz vbq
jhd: bqh nbv mxg
zth: bvg gfp zpt qkq xbq qzm tzr xbb
pzk: zfv fcx
tjx: dbb lrj dvk
bvg: jcp bnk
lzx: lxf xhz
thm: tvr lgg tss kvv sgv
ljd: dht vjh zql sss
sfn: zcx kgs xzd fff
vcs: gfh xxl jks
qxt: fxt gvv nqs
vtl: vfb hlt sgd kbp
gvm: bqs jfv zxx
rfs: tzz nfg rxn
pmk: sgf mlq nph
pcs: qtl
hfn: nst jzh dmj bbb
cpx: znz zht bcx
vhv: kzf xkt pxv hdr
cqm: vnb bkr cfk xkt
mxr: pgn tks qpx
vps: kcc rlh tnb
ndr: krr
xvv: jkb kxh mbl
nbh: bgm
hrn: qbq jgx jpd frh
snd: bgl hnl zmh vdc
sqb: krf szx fdb
vhz: nfc ljm xvb
nph: knt
lkz: llv zpr
vlg: qdb fgl zkm
jzp: chp
sjp: lbr mnh
vzz: gcl nqs rxx
rpd: hmt nzg
czj: dnz xsq lrm kck
vzl: thm gbx dzv zql
tsh: ffq
jqt: vgk kvv hdz
msb: pvc
xqh: dns mlp tmz lbl
xkh: kft sqv fmf gfh
csq: bsc sdj
fkc: bcx lbk cts fmz dlt znh ftc
lfq: tkl hld mmh grv
jzj: fxb bhz sgs
sqv: jgp xxl
vrs: qph dpm
pgn: dbt
cjl: vfb
tqb: qqm bkc ndd jzn
gbv: dzm
zfr: gcv dlc
bcx: zql tpp
tvh: ngc kbx
qvc: mlq
pfn: hdj dqr kcb qtk
hjp: vrp
nkd: tck
srf: grs mgj nqs cfn
rzj: dnr cxz pzf qsh
pzt: trb clt gcj
qjl: lds dzq vcb
cpb: jbp fdp
xcd: kch xkh pvp tln
fxm: dvd hxp
mlt: ggx gzk
znk: ddp qtl rqx
jtl: gvv mgj
lvb: phn xhb pnl fxj
szj: txg rvl hkj pfh
txf: vlg ndm ptr mrl
pgx: zfv jsc rkx
kgs: qpx vls mtx gnk
gvv: qfk
bgs: kck xgd
cts: fvt kpc blr
zpm: cbm kbx cbg mgx
szx: bnh
nlm: qsh srn
zpr: sbb
ncc: bbb bcb
xzd: hld dzp knt
cxx: zqb nbp
gsz: bbs xmx ztf jgj
sgt: xks jgl xft xnd lvb
mbx: snc vps ckp
ndx: qng pbj
hgt: zvs cmq dbb vtg chm
qqb: nkf nqd nkz
zlj: qdh zgz
dsr: thx snl qnh nxv
qgx: qqb nfc
fzx: hdj tpl rtj qnf dlc
fqp: ctg
rxn: mnh jtg
lhc: gbv gxq skv gfd
tsg: jpb qfx jgj
fpc: gcm
vjr: mvg
jkt: rfj tpp rqk
qrv: ndp
bjr: tsl
sqg: zkp
gtx: jmm cnt hdz dmr
kvv: crv
qcm: lkg nsz lzr
ssk: lcj clx pkj kqk
hdd: hrx svs
bqk: qpx
hjx: pll jgj ldt
zhv: jcv mlt
ddz: tmp zkp jcl
jsh: crc mlj jbp tlx qbq
mfl: knr
fck: kcc vrp lnh xgz
qrj: xkq nld bvs bdk
hsl: kch
dtl: bqv lzr klz bbm
qvp: cjl ktg krf xmr vxl
vpl: sss bqh
shx: mvg kxh mhs chp tsg zsj
vcb: ndp
pkr: srn pgq pfz ljl
brv: mkr vdp lxn kqg
hnm: kjk vcg tfx
pnl: qsl
ghg: gmn xjj
jll: rbv gft dth
hqq: snc pfh kpl jfx
srq: znz tpr hsz nxk
tzz: fbd gcl srn
zdk: skz xfh jdv
zlm: nss hjd vls mxr
tzj: tlt ddv fgp
khm: lnb rst trf tss
clv: msb bjr
fns: qrv qcb qkn
zhk: ghg ddj jdq fgp
fhq: hmt kfb
gsl: fcf qbf cdz cfr
dcp: tmm gdh djl vkl hmf
scs: rsn
ztn: tqk
nmg: hfp
nxk: kfz qpc
grj: cfm phn kfb gbn
grn: qhj fvj vrm
xlt: pjh zmh
gzm: kqc lzx bqx bqk
rfr: bbv
kxz: xlb nlv mlt fbn
blx: rbs mzt
dcf: dhv zmh zvr hpf
vvj: rxg psh ksq
kpc: xfm rdn
ngh: sss rdn gzk
ktk: jks nfh
vvr: hlf vtn pxx npq
jcf: pbj sgq
hbv: txp lbb lfk cqk
tpr: dlt rmj prl
pfh: ndm nzg
lds: knq
ddp: xhm hdk
tlp: sbq ptb
vts: xjj crh gkt hpx
jhm: jhb xzc fhm cnk
rrg: xvr ptb rfg kvm
cbm: fzp knq
skd: qrv cqh tlm cxz
qdr: zcx frr lfr
lkj: ntr rkg
qjf: qls tfm gxz nxv
jvt: cpx gkk hps ntd fjl
qbx: kxg fdp
qsh: pzd
fgn: knk djg kxz
slx: gfl pcs dkz
xbv: bch blr nbn
gvf: kbq mnh
lbb: jvn
dnr: skz qsl cfr
gxz: vfb qgx kcb
xsb: ppz hjd gvc
pbd: jmh
hzz: rsn nqd
fnk: nkq
vdc: kkh xfm gxq
tdf: gff clb
mlj: vrc ghx
vzc: rqj slf cxh gnk
tlm: bxj djl pqr
zrc: vtj hsl hdn
chk: vrm zhv qfd vqd gkj
rhc: qnv scg mvg vbh
txz: dqr tsh rlb
fqc: jfb csq tvh
sns: srf lqr
xgd: dps hpk fmj
dlj: svf rpd bgh hcx
zxx: xfx
drt: qzk fng
jbs: bzl llv gsm
knt: kvp qzp
pxr: dnn gzk zrz
xfr: mtj cgb
htr: sqg jgp dsp
bxj: sqc
cfh: zrq hgs fbn fgz fvj
hgs: bvj
vpd: bqs mlj
jff: clv tqp ngc
jdp: pss xtj rtx
thk: tcb bmj tsr tpl
gfd: vzs
qfb: slf gml
rsn: skv
kml: ksb xgz qfb
mlp: jkl gxz
bgz: lkg gjm lsl
tjs: clt zpr clp khd
dkn: vst hmp rfm
rqj: tlx
vkn: tkl kkz fqc tvq
jvg: tlx qln xzc
fhv: sbq bjf cxh zqc
dff: vpk kjj dvd
nmm: xhl nxk gkt nbc
tfx: vnb rlb
xbt: qxr fdb
qfq: npz kvv hjk bhl
snc: zsz
dmf: hvf mhq ddj rjk
zll: dzv jvl svn
qdp: lnt xbq
xrk: fjz
crv: dzv
ppr: szd jfb kxg
fxv: dhg cmt sqc
nqj: ljd tgs
bns: ztn ldl trb jfv
hdn: tdx ftc
qtv: gff
bqv: zxg tfx
tbx: xbv fkf csv tmx
xnk: gqz njh tgm bkh gsr
ctr: fgf
gmn: ckj
kxx: klz khf
krl: sxv
gft: vpk
qnf: xmj rxg
zjz: gst ztd
crk: mjn vcb fgf mfl lss rpb
pxv: zmd psh jpb
jzn: tmz gjm mft
bxx: drc bhz fxb
mlq: qdm
nsz: fxm zkp
rlg: dhv nlv drt ccq trl
pkz: bdk jcp
pvp: kfz smc rcq dff
bpt: prd nnj grs kqh
nmj: fbd kmj
rrn: bdk
skl: cjm xkv
fcb: jkl krl pzs hsd
hjm: tlx mjk znt
txg: gnk qdn
sbd: jcf
bqp: llv rkg zqb
jfr: zxv rxk
rsr: gbq pbx pcr sjq
zlr: grn zrq tfm
lqr: bgm
dnz: hmv kmq dhj dbd
jmq: pvn rst jdp
bmj: gft vjr
nld: rxk pbc nzs
kxg: jtm zrk
hvp: dnp pcs bvs rfg
vnc: nfg xsb rdl kzl
qxh: gsm
mrx: hdr qnh cdv gbx
vnm: mfq bcm kfj
czf: fmj pzt hmn lkl
phf: dmj jtl
jgs: pfh gsq nss
kxh: dkl rbt ghb
kzd: hjp
dbt: hkj
tln: mvg svh bqv ntz
fxr: qbc gcm
tvr: hzz cdv
sbb: jjl cpb msb
nmt: sgq knh
xcv: prs hmv htc xvr
bft: rqx rbf ndp bvf
rst: qzk xbt
csk: kmq
nbn: fkg mtj
tgt: mvr
rbt: krr
cvk: xhn bsc sgs bvf
nqd: zvs mtb vfb
kqk: ppz vvb gjc pqn
vvb: gnm fbd cxz qdm
cjm: qkn lxh
pkh: fgp hdj
rpb: tpm
bjb: cbh
rlh: gfp kvm
fpf: djk bcb
xbk: xvr csq
fhm: qxt jcm tkc
tlt: fzf ndr xtj
zdv: mtb lgg cqr ndr
xks: ktz
cmt: vkx pfz pzd qlf
xgz: crc
nkt: dvd
qxc: pls rtj bgl
tkh: zzx dkd shm sgf ctt
krk: hbv nlf jks nds
zrq: gst pll
nhf: nbh bxz fxk xzc qkc
cdz: cbm jzh
bbv: qtk
dkr: gmn kjj
scg: jzp
hlj: hzv mfj
grv: dfr xsq qdh
zqb: fzp bmm jjl
bqx: fhg cfm dhg jgs
zhf: jdq nkq
lfk: fqk rtj vmt
cpd: qls
ntd: rvc pkh
kpv: vfb vvj xsv lvr
tpt: gtl rlh bvg
mhm: qfl rgk
ztd: npz cdv ndx
dhg: hkj txg
lrl: ljl pzt cdz
gkt: zch
tzh: xnd bvs fxr qdn
jlj: kpt
mfh: pvc
vmp: dmj rfh kvp
tss: nkz
sjb: gmn
nfq: dnp zsb dvb fhg ctr
jlq: cbm kdk xrt
ckv: vtn tpl xsv
ncv: mxm
jsv: kqb lhh fmj qzm
rbr: kpt ncv gmm lgg
pgp: rdl slx fcx fhg hmv rpd
jtg: pvc
mgb: nlm njj
srj: vzz rrn knf bxx
cqr: knh
qkr: tqb fmf tsb xlt
cxz: fbd
bzl: rqx jbt mfl
nhg: mjn mmd zjg prd
qzq: sqb qqm vfb rdj
cqc: ztn zqc hxs jxx
vzs: hdt
grs: qph qfl
zdg: csc vnt hpf
bbh: rrv gtn zhv kxx
qhc: rgk lzx gcd knb
vtn: fvr
slv: dqp xkc kkh djp
gnv: dkr tsh tdx
xfq: mgx prs
rkk: gdp dff
zmn: cjl prl jdl
zst: zmh vxv snr qhj
vnk: snr xjj
bhl: mkg vtn bmv
gjh: xgp
cvs: bcf
qgl: ghq kmj vrs ncc fhv
sqp: hbv nkt fgz
xzt: xgh ndp srj vtq
nzs: kbq qfl qbf
zfj: jdj prl
xqp: mmg rrc kxx zzg qfq
jgl: lpl
mkk: rvl cpb qdm
jvl: hfp jcf qsf
fvg: cpb tzt nkd kdk
drm: hbk jcl
rnh: rfr pnj qls
xqx: rxg hdt
vtq: gfv
gkj: jgj
ghq: xqm
chm: rzq qnf
nds: ffq ggx xmb
zxg: rmj hdn
sxv: qtk
mgp: vhn fxn qrr dbt
pmv: jdh kcb hjz bsz cpd
bnh: gbv lsl
mmh: xbk sld tqp
djk: vrp
lqg: zvp klz smc
cnk: txf qsl cqj
xtj: fdb
xst: bch xkc nkf
vgk: zdz qjh qzb tpl mqg
tdx: gcv
vtr: qbc jbs ctr frh
lvd: nrh kxn kck
nlx: csq clt
hmk: bvj kkx tqd xhl
ggn: xpd sxv rqk
rfp: rmj kch
ngk: kck fzs ktz
kdf: qtv xpv ncv zfr
kzt: ftc vjh fqk
mft: pkt qng
qvt: vdn ljm zmt lbb
hnb: cjm kml gjc znk
gxf: htm lkp prh rhr
nqb: nbp djk tgv cmt
tzx: zkr qph nth
bsz: pbd gfd hsd
tqp: rxn
nqs: bjr jcp
jnj: kcp fgc kft rtl
xdj: nfc spq
stb: lds hld
npm: svh
gfp: zrk
hzf: hnl rbt dmb qhj
zxl: grl qkq
dkt: tdf xvd rfm
fbn: zfj pbd
dpr: jxh xhb
ctt: bnk njn jcp
bsx: qbf xfx fmj fgl
kqc: cfn sjp
szd: fdp fxl
vqm: hnx pkh vxl
vkl: tvq qdp
xhn: phn
cnv: pll jzt
nqp: rhx zgz gnm
ldt: vnb
snr: mkg gzk
sxf: tpm sbb
gcd: mkk jtg znt
cfr: hdk
qgz: zdg pxr sff pbj zvp pzn
rfg: pcz gfv
jhk: fdl kct bjb
bjh: mbx fxb jss htc ncc
frr: gxm kns
znz: dsp npm
kkn: knf vfd hzr nzs
spg: gsq msp dnp
prs: rrn
csv: svh bbv jdj
chd: lgg njg hjx gkk
kqp: gvs jfb hmf
ltd: rvb gft ngh fml
rgt: jhb vhh jfx
hmp: vtn
qpc: qhj
tmg: lnt sqc
zpg: nqp qfk nrz vkx mzf ppz
tkz: fgc gfd nkz sqg tjx
psk: hsg vfd qpx
jxx: gsj gvs
pgk: cqr gff fgq hlt
pdd: lpl ftl gkb
mzf: gqz vps
jkr: fzp qrz gsm fcx
qlf: qdm prs tzt
zvr: npm vpk
bfs: cpd lsl snr xxl
ljh: bdb qjl dnz qzp
pbc: tqp xkv kcv
mgk: fsq gdp
kzf: bmv ttm sbp tdf
ptr: xxj jhb
mhq: smc jhk
msp: xzc tzr knb gkb mkr
fdq: zrk ztz pcz
bbs: bkc gvl
tpb: hnb jgl skl
qmb: rfp xtm zdv xvv fpz
dkl: nps qjk xrk
vfd: lxr cxx
zmt: xlt sgd
svf: lqr sfg csq
xft: lds cfm
vsl: dfp spq
hzv: rfh lpl ccv tgv
dsv: lrj gbv hnl
nbg: hsd tsr nmt ljm
rkx: qfb zjg
mfq: fpc flg
mdx: qzb vhz xjv vqj
mzt: xhl vmt
vbc: blh
bhz: fpc
zfv: sbs
sbp: ddz mgk
snn: hgg njh slf
mfs: nph sjp vbc
dlt: hbv qzk
bxc: fmz rdn vjh
vqx: xgb kdf zhf sgd
lqq: jfr jjl nlm dvb
jpn: tgm fhq mgb sgf hjm jtm
ppz: fxb
tls: qht tzj nlv xpb
xsx: nmg fbx vzs prl
fqt: pxx rxg nqj zxg
skz: rkg sbb
ksq: rtx
ghx: xnd ktn
xpl: hmp gqh hdd zhf
qrz: kqh
rfh: ztx
zmr: rjd nkd hxs
cmq: hqx hlx bnh
fqk: fjz
cqn: sqb lqg zkp fqp
cgb: tqd
hcs: hdr xrk zvs xmj
bqf: jjr qbb dsx
cht: qrz qkc jbp vhh
nfg: qvc njn
mxg: pzg xbt
fng: gbx knk vpf vdc
kxv: qcb lxh xqm
ccr: djp
ptn: hpx
vmc: djg cdj rnh
gmt: xqh vqd nfk hll
rlk: mgx bgs vdp vfs
jjr: qfl bjf
nzg: npt tgg zxv
zlg: lqr fgl blh fck
kmc: fvt khb rlv bjb
fnt: pnv kcc ctj mlv
xpd: sss
hdz: cnv
tth: ctj htc mgb pmk
kkh: rdn
ccz: xks hgg mjn nth
kft: txp
xnq: vdt cqr hdz
fxk: vss xxj snn
qkj: nbh bbb lsx
msl: jfr prh qvc
rqk: mqg pxl nbg
dpm: gcl vrp fzs
bjm: zcq jpd zlx nqz
nnt: gcj vpd cst htm
hfc: jnz jxg
fmf: rlv
lcv: tcg khd jtl spg
dsx: gnk gxm lxh ldf
qbb: kmq
zld: tqd gjz dht xnq
mjt: qzk ffv hsl
lhm: bhz rvl hkk
znh: fnk hbk njg
npq: dzm vdt slp
jpb: vrm
lsx: jhb prh
qkq: dhj
zjj: vtq mfh mck xzt
mmg: bqh xst lhc
lvm: cjl nbv gnv zhv
zjr: rlt fvt dqr nbv
mth: tss qgx mzt sgq
grl: xsq
fzs: ckp
vfg: nfh npm lnb dvk zdz fcd
sjq: clx sbq xxj fhq pkz
djl: pmb rxn
hdh: vhv kct mfx
njg: pll
gzq: hqq gnx vkl szd gbn
dqr: nsz
jxb: jff sfg
bdf: jss cqh vmb kvp dzq
hbk: pls
blj: tmp zdz rlv
jzv: dpr qkc
rdl: jss
rsp: kcc mhk
tkp: cnv chp vst
pmp: fnk qxr tgt gcv fzf
kxc: gfh sqb
klx: jdl ptn rrv
rmv: bqs xrt
chh: ctv lxh rhx vrp
tck: mlq
hsz: dmz fld knk
hcv: lzr scg fzk gkj
grx: svs cdj sjg
gqh: hlb grb bnh
gmc: jkt hxp mxm
ffv: kch ckj ffq
bzh: hjk gmn ttg
ldl: hcx ftl tpx
zxv: bcf
vcz: pxf pls hjk
hpx: vmt
tks: qdp
hqx: dmb vst lhq
mkb: fcd vdt
hld: njj
gdp: qhj
bpb: zpr cpb
ghb: fmd
gvj: sbk mhk rqx
gnc: kxv xft gps scd
gbn: sdj
mvr: vnb
trf: rjk jzp vzs
clh: snc rfs vkx
lbk: mhs
nbp: rqj cqs
cxg: nkf dmb qpc
rlt: qng mft
xgb: xvd mxm
sxz: kcc qjl bqs
qbm: cqc shz jjr xhn
drc: fgv
ftc: qtk
kjv: rsn xmj fmz
mrl: pvc
ttg: xkc jpb gvl svn
nbc: dkr jlj nlf
tmm: tzp thf szj
flg: njn bzs xzm zrk
slp: jdl ksq rtx mft
pkt: gmq jvn tgs
qqm: jmh
jdh: dzm tcb jvl
zdz: ccr
vhn: nnj mjn
vrc: djk
tcg: jxx mlq jgx
zqp: zvr jcv
vmb: kns nqs
hrc: mhq qvt vcg dkn
cvx: hmp knk kft lbb qfx
bvf: njj zfv
rzq: pzg bzh
qpf: shm ljx kpl nkd
xsv: zvs
xcz: kfb xnd
pdn: pzk mkd gcm
gvq: xzm tlm dxc pnv mhk
gzs: mbl fvr xpd
hsg: lbr
bdm: ncc nbp hgg gqz xfq prf
dth: xfm hnl qsf mkg
pbx: gcm qph ghq bqp
ldr: krf ktk
qhj: rdj
cxb: qnv ndx qjf ctg fvt
qrg: ctr rkg gcj bgs dtr
qhk: vhd xqm
zqc: vzz rvk
knf: dxc prd jsc
jgf: qst dzp kzd zxx
npz: hfp lbk
fjz: svh hpx skv
vxb: hmf sgs vbc nth
hnz: hjp xhm nph
hgd: xsv rbv rlg
dtr: qsl
fkg: fmd zpk
nth: vhd jpd ccv
kmh: jzp kkx
gbq: rxh gvf xds zmr rhr
plx: jzv pmk ddp bcf
xzg: lxr clh bxj sxk
kkx: mkg
xhm: tnb ktn
qxg: spn vcb zdk ssj vjj
fqx: lxf rrn pbc
sbj: prh cst ptb ktn
skm: pnj zmt vxl xdj
rvc: lnb kbp
nrz: kgq lrl fxt
bqh: ddj mvr
zqf: xvb tsr ztf thx
zfx: vtt lzq xpb grn
jkn: rmj cfn klx
mdm: qvc kfj kzd
hll: gff crv xtj qnv
tqq: mgk fnk cxg thx
snl: fsq tgt
kzl: fzs lnh jnv jzh
snh: rlt vtt fgp vnb
fxl: prs nhx
blr: sjg
gsc: jzj hsg qzp vpd
vbh: zdz dvk grb
gvc: ssj jnz mjn
rkn: ztx hmt ldf
szc: hnx vdd kfz jkn
pls: gfd
fkf: mxg rdn vrm
gsq: zlj cfn jxb
vmz: tmp fdl
jhv: pgn pmb
qnv: rxg hsl pbj mxm
tzp: jgx ldf pkj
bxv: fpf dpr shb hzr rth
sgs: srn
pdh: lzq tkp ndt zvp
ppj: jxh pcs mkr
rrk: dhj lss mjn czp
jcv: dqr mfx
xgh: rrn lhm
gmz: rdj vpn ldt hpf gff
zkm: lbr bcf xrt gps fgl gpn jfx
hgg: dzq zgz
lqn: qht dht rlv ptn
jfb: knr
thf: rfg mtx stb shb
rqr: gfh fqp rpt tvr
vsk: tvh pnl qst phf jgx
hlc: pzf lkj bmm sbk
rhd: gsj
zcq: hkj pzk kvm
trb: ckp grc
zht: dpj fgn xmj
hvr: vjk lvf pfz rmv
trl: hlf cbh
pdl: jsh hfn zmc vsk
qnh: sbd
jxg: bpb rxx
vgv: pdn drc msb hkk
tmx: pnj hsd
jmm: cqk fbs qpc
tgv: gnx
zql: rfp
pqn: cvs csk zjg
fsh: gpn vzc dxk dzc
nrh: jhv gkb gvv
psv: dht
hlb: zll fbx
ktb: qxh rdl jzh jnl
xds: vtq kdk
psr: njg bbv csc xpv
ktn: mtc
mld: zrq qcm lhq vpn
pgm: mfx tss bdt
rvb: blr
jcm: bpb kmj
dxc: xhb qdb
pjm: zvp gxz kbp nkf
rvj: dnn cqk
pjz: xnq bbm gdp lpm xpv
kbq: cqj fzp
kgq: dhg qdn
nfk: gff jcv
rtl: bfl hjk srq
fdl: trl
hcx: zlx htc
hbl: kxn hdk sfd mdm
tkj: mjk npt ngk czh
kqh: mtc
pzf: zsz
nzl: ppz jtg hmf
ctj: jcm xfx tmg phn
hrf: clb hgs vmt hdh fsq xtj knh
xhl: jdq
mtx: hlj rvl
zgz: knr tqk
dpz: rgt qbb qrz
scd: sxf sbs
slr: qln bgm
sld: kxv rdl ghx
lgp: fdb zzq gst sqp
vqd: sxm zkp vxl
cmv: pvn ndt mtj
prf: xcz tks
hdj: sxv
xmc: sgd ttm mtb ldr
ntz: rbs bdt
pqr: xhb
dkz: kdk gfv
rcx: gmq qtv cbh kpt
xlb: xqx lkg grt
mhv: ckv jmh vbh zst jmq
fgz: dlc
qst: vkn lxf
gfl: tzt gxm qxh
kcv: kvp
mqg: pll
ptb: rbf
gml: hbs qkn
scl: kmj vss gjc vmp
bpg: vfh crc czp gfv
kbp: nfc fbx
jdn: lsx qsh qdb pbc
cst: zzm gxm
dcv: vqm ghb rfm
fcc: mqg djp
krx: txz pgm
rxk: sbb
lss: lnt
zrm: hbs cst jvg zsq
mcl: tlp jnv nbp bcb tpx
dkd: tth lxn kgq gnc mzf
fgq: tgs
qnb: fzx pxf jck zdz fcc
gfn: rqr krx mhq jkb
xkt: nkq
khl: kjj hlb
sxm: xkc tgt xsv
vnt: llq jzt
kfx: xqx szx